WWWWWWWWWWW
W         W
W         W
W     D   W
W         W
W  BB   E W
W  BB     W
W KBBBB   W
WWWWWWWWWWW