WWWWWWWWWWW
W    BBBBBW
W       D W
WBBB     KW
W         W
W  BB     W
W  BB     W
WE BBBB   W
WWWWWWWWWWW