WWWWWWWWWWWWWWWWWWWWWWWWW
W   B CC BWWECCCCCCCCCCWW
W  CCCCB     CCCCBBBCCHWW 
WBBCBBBC BBBC  B   BCWWWW
WHBCBBBC BBBC BBBB BC SCW
WE C BBCEBBBB  BB    BCHW
WBBCBCBBBBBBS     WWC SCW
WCCCBCCCE   CCCCCCHWCWWWW
WWWWW WWWWWWWWWWWWWWWWWWW
WECCCCCCBBBB A WCC SWC SW
WBBBCCCEBBC  WWW WW   C W
WECCCBBBBBC  CCA WC CWC W
WBBBCCCE  A HBBBCWCDCWCKW
WWWWWWWWWWWWWWWWWWWWWWWWW